##############
##############
##############
##############
#######################################################################################################
############+####################################
###########+.###..###############################
.......]=..........###.+#########...###
.......]...@...##........................############################################################
.......]=....####..................E......+########...##############################..*..######
###########..##.........E............................++##########################=====....#
###########.###..####+++.########=======####.....*...#############+.*..++########=++...=...
##########......###################...+########......+####+++###...*.*..######++.=..E..=..
##########+..++####################..++########......####====##=======..=######..=.....=+++
##############################################.......####..........###...###..S..=.....=++
##############################....##########.....S..#####===...===+####...###....=+...+=##
###################..=..........*........+##........#####=..S..*.=+###...####+...==...==.++
##############+++....=......E.....................++#####=..*....=##+.....####...............+
#################+...=......E...........####.....+++#####=.....S.=##...E...##..........E..
######################+........++#######################+=...*..==.......................
#########################....###########################+===...===....##......*..*........++
#########################...##########################.......E......###############.....
#########################..###################.......................++#########++.......[............
#########################..################+.......E....#####===...E.====########........[............
#########################..+######..######.....##....++########++.......+#######+........[............
#######################......=.E....E.........#####################====.==#######...S..
###################++.=.........*..E.....++#######################.=..*.*.=..++###....
#######################......=..S.E.....########################.+E*.*.*.*..E#####.....
#########################++.####################################++.E*.S..S=+######=====
###########################+#########################################==###=########...
##################################################++##############################....+################
#################################################++++#################.....*..........#################
###################...==========================================================.......+###############
###############.......=..=..=..=..=..=..=.........++++++++++++++++++++++=.E............+###############
###########...........=S.=S.=S.=S.=S.=S.=...S.....E.....++++++++++++++..=.E............+###############
###########...........=.==.==.==.==.==.==...=...........E....+++++......=......=...*...################
###########...........=....................S=......++E......E.....E.....=....S.=.....##################
###########...................................E.++++++++..E....E.....E..=......=...####################
##############...............S.........S.....++++++++++++++..++++..............=++#####################
##################...#==========================================================#######################
##################]]]##################################################################################
##################...##################################################################################
##################...################################
##################...################################
##################...################################
##################...################################