##############
##############
##############
##############
##############
############+######
###########+.###..#
##########........####.+#########...###
#########.....@#.........................##
###########..###...................*......+########...###
###########..#..........*............................++#############
###########.##.#.####+++.########.......####.........####
##########......###################...+########......+#
##########+..++####################..++########......#
##############################################.......#
############################################.....*..##
###################......................+##........##
##############+++...........*.....................++##
#################+..........*...........####.....+++##
######################.........++####################
#####################################################
#####################################################
#####################################################
#####################################################
#####################################################