##############
##############
##############
##############
##############
############+######
###########+.###..#
##########........####.+#########...###
#########.....@#.........................##
###########..###...................E......+########...###
###########..#..........E............................++#############
###########.##.#.####+++.########.......####.........####
##########......###################...+########......+#
##########+..++####################..++########......#
##############################################.......#
############################################.....S..##
###################......................+##........##
##############+++...........E.....................++##
#################+..........E...........####.....+++##
######################+........++####################
#########################....########################
#########################...#########################
#########################..##########################
#########################..##########################
#########################..+#########################
#######################.............E....##############
###################++....................++#########
#######################.........S.......############
#########################++.#########################
###########################+#########################
#####################################################
#####################################################
#####################################################
#####################################################
#####################################################