######
####.######
###..###..#
##........####..##
#.....@#..........#
###..###..........#
###..#............#
###.##.#.####....#
##......##
##.....##
########