###########################
###########################
#####...............###########
#####....@......!.......[.###
#####...........!.......[.#########
###############.........[.##############
###################....######
###################....######
###################....############
###################.............####
###################.............###
##################################
##################################