###########################
###########################
#####...............###########
#####....@................###
#####.....................#########
###############...........##############
###################....######
###################....######
###################....############
###################.............####
###################.............###
##################################
##################################